SO ./assets/textures/south_texture.png
NO ./assets/textures/north_texture.png
WE ./assets/textures/west_texture.png
EA ./assets/textures/east_texture.png

F 10,10,10
C 100,100,100

1111111111111111111111111
1000000000110000000000001
1011000001110000000000001
1001000000000000000000001
111111111011000001110000011
1000000E0011000001110111111111111
11110111111111011100000010001
11110111111111011101010010001
11000000110101011100000000001
10000000000000000000000010001
10000000000000001101010010001
110000011101010111110111100111
11110111 1110101 101111010001
11111111 1111111 111111111111
