SO ./assets/textures/south_texture.png
NO ./assets/textures/north_texture.png
WE ./assets/textures/west_texture.png
EA ./assets/textures/east_texture.png

F 220,100,0
C 225,30,0

1111

100001
1111
